111111
111111        
1ECP01          
111111