    
                                             
                                                  
1111111    
11C10P1                         
1E001C1              
1111111
                                                   
                                                             


                                                             