    
                                             
                                                  
111111111111111111111111111111
1P0000000010000000000C000000E1
10111110101010MMM0101010111101
100000001010100010001010000001
11111010101011111011M010111101
1C00010100000000000000001000C1
1011101111M11011M11111M0111101
100010000000101000000000000001
1010111111M0101011111111111101
1C00100000000000100000000000C1
101011111111111111101111111101
100000000000000000001000000001
10M110111111101111111010111101
1C0001MMM0000000000001000000C1
111111111111111111111111111111             
                                                             


                                                             