    
                                             
                                                  
111111111111111111111111111111
1P00000000000000C0000000000001
101111100000001101111111111101    1
1C00001C0000000000000C000000E1
101100000000000000000000010101
1M00000000001M0000000000000001
101011101110000000101110111101
1C00000000001C000000C0000000C1
101111111011001111011110011101
1M00000001M00000001M0000000001
101110000000001110101111101101
1C00001C00001C00001C00001C0001
101110110011011000000111011101
1M0000000000000000000000000001
111111111111111111111111111111            
                                                             


                                                             