    b
111111111                                                                   
1M1M11CC1     
1010P1011                         
1000000E1              
111111111