
                        
111111                 
   
1E0CP1         
111111                