    
                                             
                                                  
111111111111
1P000000CM01
101111110111
100000000001
101110111111
1M0000000001
10111E111111
111111111111
           
                                                             


                                                             