    
                                             
                                                  
11111111111111111111111111111111111
1P00000000000000000000000000000CM01
10111111000000000011110000000000111
10000000000000000000000000000000001
1011101100000000000111C000000001111
1M000000001100000000000000000000001
10111E11000000000000000000000001111
11111111111111111111111111111111111
           
                                                             


                                                             